,1,2,3,4,5,6,7,8,9
0,Time,Type,Order,Size,Price,S / L,T / P,Profit,Balance
3,2019.01.02 07:20,s/l,1,1.00,1.14511,1.14511,1.14404,-57.00,999943.00
7,2019.01.02 07:50,t/p,2,1.00,1.14711,1.14611,1.14711,50.00,999993.00
8,2019.01.02 10:38,s/l,3,0.10,1.14336,1.14336,1.15336,-25.00,999968.00
11,2019.01.02 16:55,t/p,4,0.10,1.13620,1.14620,1.13620,75.00,1000043.00
14,2019.01.03 10:40,s/l,5,0.10,1.13825,1.13825,1.12825,-24.91,1000018.09
17,2019.01.03 13:07,s/l,6,0.10,1.13591,1.13591,1.14591,-25.00,999993.09
20,2019.01.03 17:01,s/l,7,0.10,1.13749,1.13749,1.12749,-25.00,999968.09
23,2019.01.04 15:40,s/l,8,0.10,1.13741,1.13741,1.14741,-25.64,999942.45
26,2019.01.07 10:01,t/p,9,0.10,1.14387,1.13387,1.14387,74.36,1000016.81
29,2019.01.09 16:40,t/p,10,0.10,1.15148,1.14148,1.15148,73.73,1000090.54
32,2019.01.10 20:25,s/l,11,0.10,1.14860,1.14860,1.15860,-26.91,1000063.63
35,2019.01.11 02:01,s/l,12,0.10,1.15153,1.15153,1.14153,-24.97,1000038.66
38,2019.01.11 12:55,s/l,13,0.10,1.15405,1.15405,1.14405,-25.00,1000013.66
41,2019.01.11 16:10,s/l,14,0.10,1.15019,1.15019,1.16019,-25.00,999988.66
44,2019.01.11 16:52,s/l,15,0.10,1.14683,1.14683,1.15683,-25.00,999963.66
47,2019.01.15 18:37,t/p,16,0.10,1.13921,1.14921,1.13921,75.06,1000038.72
50,2019.01.22 16:08,t/p,17,0.10,1.13379,1.14379,1.13379,75.20,1000113.92
53,2019.01.23 17:35,s/l,18,0.10,1.13809,1.13809,1.12809,-24.97,1000088.95
56,2019.01.24 10:22,s/l,19,0.10,1.13574,1.13574,1.14574,-26.91,1000062.04
59,2019.01.24 10:40,s/l,20,0.10,1.13757,1.13757,1.12757,-25.00,1000037.04
62,2019.01.24 19:37,t/p,21,0.10,1.13011,1.14011,1.13011,75.00,1000112.04
65,2019.01.25 04:55,s/l,22,0.10,1.13207,1.13207,1.12207,-24.97,1000087.07
68,2019.01.25 17:25,t/p,23,0.10,1.14010,1.13010,1.14010,75.00,1000162.07
71,2019.01.30 21:31,t/p,24,0.10,1.14833,1.13833,1.14833,73.09,1000235.15
74,2019.01.31 18:10,s/l,25,0.10,1.14598,1.14598,1.15598,-26.91,1000208.24
77,2019.02.01 15:46,s/l,26,0.10,1.14811,1.14811,1.13811,-24.97,1000183.27
80,2019.02.01 17:10,s/l,27,0.10,1.14599,1.14599,1.15599,-25.00,1000158.27
83,2019.02.04 16:55,s/l,28,0.10,1.14289,1.14289,1.15289,-25.64,1000132.64
86,2019.02.07 10:02,t/p,29,0.10,1.13534,1.14534,1.13534,75.14,1000207.78
89,2019.02.07 17:10,s/l,30,0.10,1.13529,1.13529,1.12529,-25.00,1000182.78
92,2019.02.11 17:40,t/p,31,0.10,1.12773,1.13773,1.12773,75.06,1000257.84
95,2019.02.12 18:05,s/l,32,0.10,1.13046,1.13046,1.12046,-24.97,1000232.87
98,2019.02.13 16:10,s/l,33,0.10,1.12806,1.12806,1.13806,-25.64,1000207.23
101,2019.02.14 15:38,s/l,34,0.10,1.13055,1.13055,1.12055,-24.91,1000182.32
104,2019.02.15 15:33,t/p,35,0.10,1.12345,1.13345,1.12345,75.03,1000257.35
107,2019.02.15 15:40,s/l,36,0.10,1.12586,1.12586,1.11586,-25.00,1000232.35
110,2019.02.15 16:23,s/l,37,0.10,1.12841,1.12841,1.11841,-25.00,1000207.35
113,2019.02.18 03:52,s/l,38,0.10,1.13101,1.13101,1.12101,-24.97,1000182.38
116,2019.02.19 13:25,s/l,39,0.10,1.12856,1.12856,1.13856,-25.64,1000156.74
119,2019.02.20 11:23,t/p,40,0.10,1.13576,1.12576,1.13576,74.36,1000231.10
122,2019.02.20 18:10,s/l,41,0.10,1.13619,1.13619,1.12619,-25.00,1000206.10
125,2019.02.20 21:10,s/l,42,0.10,1.13367,1.13367,1.14367,-25.00,1000181.10
128,2019.02.28 13:15,t/p,43,0.10,1.14120,1.13120,1.14120,68.63,1000249.73
131,2019.02.28 15:35,s/l,44,0.10,1.13907,1.13907,1.14907,-25.00,1000224.73
134,2019.02.28 17:20,s/l,45,0.10,1.13662,1.13662,1.14662,-25.00,1000199.73
137,2019.03.01 04:40,s/l,46,0.10,1.13634,1.13634,1.14634,-25.64,1000174.09
140,2019.03.01 16:25,s/l,47,0.10,1.13884,1.13884,1.12884,-25.00,1000149.09
143,2019.03.01 19:55,s/l,48,0.10,1.13651,1.13651,1.14651,-25.00,1000124.09
146,2019.03.06 15:40,t/p,49,0.10,1.12871,1.13871,1.12871,75.09,1000199.18
149,2019.03.07 15:37,s/l,50,0.10,1.12609,1.12609,1.13609,-26.91,1000172.27
152,2019.03.12 00:10,s/l,51,0.10,1.12696,1.12696,1.11696,-24.91,1000147.36
155,2019.03.15 16:10,t/p,52,0.10,1.13433,1.12433,1.13433,71.81,1000219.17
158,2019.03.20 20:05,t/p,53,0.10,1.13980,1.12980,1.13980,73.09,1000292.26
161,2019.03.21 16:40,s/l,54,0.10,1.13737,1.13737,1.14737,-26.91,1000265.35
164,2019.03.22 10:53,t/p,55,0.10,1.12973,1.13973,1.12973,75.03,1000340.38
167,2019.03.25 17:10,s/l,56,0.10,1.13294,1.13294,1.12294,-24.97,1000315.41
170,2019.03.26 07:50,s/l,57,0.10,1.13065,1.13065,1.14065,-25.64,1000289.77
173,2019.03.28 13:25,t/p,58,0.10,1.12309,1.13309,1.12309,75.12,1000364.89
176,2019.04.03 12:48,s/l,59,0.10,1.12550,1.12550,1.11550,-24.88,1000340.00
179,2019.04.04 12:40,s/l,60,0.10,1.12219,1.12219,1.13219,-26.91,1000313.09
182,2019.04.05 15:31,s/l,61,0.10,1.12453,1.12453,1.11453,-24.97,1000288.12
185,2019.04.05 18:16,s/l,62,0.10,1.12114,1.12114,1.13114,-25.00,1000263.12
188,2019.04.08 11:31,s/l,63,0.10,1.12352,1.12352,1.11352,-24.97,1000238.15
191,2019.04.12 12:10,t/p,64,0.10,1.13121,1.12121,1.13121,71.18,1000309.33
194,2019.04.12 23:08,s/l,65,0.10,1.12931,1.12931,1.13931,-25.00,1000284.33
197,2019.04.15 10:20,s/l,66,0.10,1.13172,1.13172,1.12172,-24.97,1000259.36
200,2019.04.16 04:55,s/l,67,0.10,1.12934,1.12934,1.13934,-25.64,1000233.72
203,2019.04.17 10:40,s/l,68,0.10,1.13231,1.13231,1.12231,-24.97,1000208.75
206,2019.04.17 16:05,s/l,69,0.10,1.12991,1.12991,1.13991,-25.00,1000183.75
209,2019.04.23 15:55,t/p,70,0.10,1.12222,1.13222,1.12222,75.17,1000258.92
212,2019.04.25 11:23,t/p,71,0.10,1.11351,1.12351,1.11351,75.12,1000334.04
215,2019.04.25 17:10,s/l,72,0.10,1.11482,1.11482,1.10482,-25.00,1000309.04
218,2019.04.29 19:35,s/l,73,0.10,1.11752,1.11752,1.10752,-24.94,1000284.10
221,2019.05.01 21:07,t/p,74,0.10,1.12547,1.11547,1.12547,73.73,1000357.82
224,2019.05.02 10:53,s/l,75,0.10,1.12189,1.12189,1.11189,-24.91,1000332.91
227,2019.05.02 16:37,s/l,76,0.10,1.11886,1.11886,1.12886,-25.00,1000307.91
230,2019.05.06 19:55,s/l,77,0.10,1.12065,1.12065,1.11065,-24.94,1000282.97
233,2019.05.07 14:55,s/l,78,0.10,1.11821,1.11821,1.12821,-25.64,1000257.33
236,2019.05.08 05:25,s/l,79,0.10,1.12018,1.12018,1.11018,-24.97,1000232.36
239,2019.05.09 11:22,s/l,80,0.10,1.11777,1.11777,1.12777,-26.91,1000205.45
242,2019.05.16 17:18,s/l,81,0.10,1.11715,1.11715,1.12715,-29.46,1000175.99
245,2019.05.24 09:10,s/l,82,0.10,1.11964,1.11964,1.10964,-24.77,1000151.22
248,2019.05.29 09:55,s/l,83,0.10,1.11579,1.11579,1.12579,-26.91,1000124.31
251,2019.05.31 17:31,s/l,84,0.10,1.11781,1.11781,1.10781,-24.88,1000099.43
254,2019.05.31 17:52,s/l,85,0.10,1.11543,1.11543,1.12543,-25.00,1000074.43
257,2019.06.03 20:35,t/p,86,0.10,1.12289,1.11289,1.12289,74.36,1000148.79
260,2019.06.05 15:25,t/p,87,0.10,1.13053,1.12053,1.13053,73.73,1000222.52
263,2019.06.05 17:01,s/l,88,0.10,1.12681,1.12681,1.13681,-25.00,1000197.52
266,2019.06.05 18:40,s/l,89,0.10,1.12431,1.12431,1.13431,-25.00,1000172.52
269,2019.06.06 14:55,s/l,90,0.10,1.12652,1.12652,1.11652,-24.91,1000147.60
272,2019.06.07 17:25,t/p,91,0.10,1.13396,1.12396,1.13396,74.36,1000221.97
275,2019.06.10 02:01,s/l,92,0.10,1.13158,1.13158,1.14158,-25.64,1000196.33
278,2019.06.11 20:48,s/l,93,0.10,1.13371,1.13371,1.12371,-24.97,1000171.36
281,2019.06.12 16:46,s/l,94,0.10,1.13080,1.13080,1.14080,-25.64,1000145.72
284,2019.06.14 15:55,t/p,95,0.10,1.12328,1.13328,1.12328,75.12,1000220.84
287,2019.06.20 04:07,s/l,96,0.10,1.12609,1.12609,1.11609,-24.83,1000196.01
290,2019.06.21 19:10,t/p,97,0.10,1.13381,1.12381,1.13381,74.36,1000270.37
293,2019.07.01 10:10,s/l,98,0.10,1.13168,1.13168,1.14168,-30.10,1000240.28
296,2019.07.01 14:05,s/l,99,0.10,1.13411,1.13411,1.12411,-25.00,1000215.28
299,2019.07.05 10:37,t/p,100,0.10,1.12686,1.13686,1.12686,75.17,1000290.45
302,2019.07.23 08:55,t/p,101,0.10,1.11895,1.12895,1.11895,75.46,1000365.92
305,2019.07.25 14:55,t/p,102,0.10,1.11143,1.12143,1.11143,75.12,1000441.03
308,2019.07.31 21:10,s/l,103,0.10,1.10887,1.10887,1.11887,-27.55,1000413.48
311,2019.07.31 21:15,s/l,104,0.10,1.11112,1.11112,1.10112,-25.00,1000388.48
314,2019.08.01 03:52,t/p,105,0.10,1.10463,1.11463,1.10463,75.09,1000463.57
317,2019.08.01 18:35,s/l,106,0.10,1.10655,1.10655,1.09655,-25.00,1000438.57
320,2019.08.05 11:35,t/p,107,0.10,1.11408,1.10408,1.11408,73.73,1000512.30
323,2019.08.14 17:05,s/l,108,0.10,1.11553,1.11553,1.12553,-30.73,1000481.56
326,2019.08.16 15:40,t/p,109,0.10,1.10699,1.11699,1.10699,75.12,1000556.68
329,2019.08.16 17:25,s/l,110,0.10,1.10913,1.10913,1.09913,-25.00,1000531.68
332,2019.08.23 18:07,s/l,111,0.10,1.11231,1.11231,1.10231,-24.80,1000506.88
335,2019.08.26 20:10,s/l,112,0.10,1.10998,1.10998,1.11998,-25.64,1000481.25
338,2019.08.30 17:50,t/p,113,0.10,1.10294,1.11294,1.10294,75.17,1000556.42
341,2019.09.04 12:10,s/l,114,0.10,1.10138,1.10138,1.09138,-24.91,1000531.51
344,2019.09.05 16:55,t/p,115,0.10,1.10844,1.09844,1.10844,73.09,1000604.60
347,2019.09.05 17:22,s/l,116,0.10,1.10603,1.10603,1.11603,-25.00,1000579.60
350,2019.09.05 20:25,s/l,117,0.10,1.10346,1.10346,1.11346,-25.00,1000554.60
353,2019.09.09 15:40,s/l,118,0.10,1.10597,1.10597,1.09597,-24.94,1000529.65
356,2019.09.10 14:10,s/l,119,0.10,1.10348,1.10348,1.11348,-25.64,1000504.02
359,2019.09.12 14:46,s/l,120,0.10,1.10592,1.10592,1.09592,-24.88,1000479.13
362,2019.09.12 14:50,s/l,121,0.10,1.10347,1.10347,1.11347,-25.00,1000454.13
365,2019.09.12 14:52,s/l,122,0.10,1.10053,1.10053,1.11053,-25.00,1000429.13
368,2019.09.12 14:55,s/l,123,0.10,1.09759,1.09759,1.10759,-25.00,1000404.13
371,2019.09.12 15:40,s/l,124,0.10,1.09367,1.09367,1.10367,-25.00,1000379.13
374,2019.09.12 16:20,s/l,125,0.10,1.09708,1.09708,1.08708,-25.00,1000354.13
377,2019.09.12 16:37,s/l,126,0.10,1.10008,1.10008,1.09008,-25.00,1000329.13
380,2019.09.12 16:52,s/l,127,0.10,1.10279,1.10279,1.09279,-25.00,1000304.13
383,2019.09.12 17:37,s/l,128,0.10,1.10614,1.10614,1.09614,-25.00,1000279.13
386,2019.09.16 13:40,s/l,129,0.10,1.10427,1.10427,1.11427,-26.27,1000252.86
389,2019.09.17 18:55,s/l,130,0.10,1.10664,1.10664,1.09664,-24.97,1000227.89
392,2019.09.18 12:10,s/l,131,0.10,1.10388,1.10388,1.11388,-25.64,1000202.25
395,2019.09.18 17:52,s/l,132,0.10,1.10627,1.10627,1.09627,-25.00,1000177.25
398,2019.09.23 10:35,t/p,133,0.10,1.09883,1.10883,1.09883,75.14,1000252.40
401,2019.09.24 15:40,s/l,134,0.10,1.10055,1.10055,1.09055,-24.97,1000227.43
404,2019.09.25 14:55,s/l,135,0.10,1.09809,1.09809,1.10809,-25.64,1000201.79
407,2019.09.26 22:40,t/p,136,0.10,1.09110,1.10110,1.09110,75.09,1000276.88
410,2019.09.27 13:52,s/l,137,0.10,1.09337,1.09337,1.08337,-24.97,1000251.90
413,2019.09.30 14:22,s/l,138,0.10,1.09109,1.09109,1.10109,-25.64,1000226.27
416,2019.10.01 18:38,s/l,139,0.10,1.09337,1.09337,1.08337,-24.97,1000201.30
419,2019.10.02 11:50,s/l,140,0.10,1.09102,1.09102,1.10102,-25.64,1000175.66
422,2019.10.02 14:25,s/l,141,0.10,1.09344,1.09344,1.08344,-25.00,1000150.66
425,2019.10.02 20:22,s/l,142,0.10,1.09598,1.09598,1.08598,-25.00,1000125.66
428,2019.10.11 13:50,t/p,143,0.10,1.10355,1.09355,1.10355,67.99,1000193.65
431,2019.10.11 17:55,s/l,144,0.10,1.10297,1.10297,1.11297,-25.00,1000168.65
434,2019.10.15 15:20,s/l,145,0.10,1.10011,1.10011,1.11011,-26.27,1000142.38
437,2019.10.15 17:25,s/l,146,0.10,1.10258,1.10258,1.09258,-25.00,1000117.38
440,2019.10.16 09:20,s/l,147,0.10,1.10524,1.10524,1.09524,-24.97,1000092.41
443,2019.10.17 12:35,t/p,148,0.10,1.11108,1.10108,1.11108,73.09,1000165.50
446,2019.10.25 16:46,s/l,149,0.10,1.10886,1.10886,1.11886,-30.10,1000135.40
449,2019.10.29 18:03,s/l,150,0.10,1.11187,1.11187,1.10187,-24.94,1000110.46
452,2019.10.30 20:40,s/l,151,0.10,1.10941,1.10941,1.11941,-25.64,1000084.82
455,2019.10.31 02:07,t/p,152,0.10,1.11557,1.10557,1.11557,73.09,1000157.91
458,2019.10.31 16:25,s/l,153,0.10,1.11316,1.11316,1.12316,-25.00,1000132.91
461,2019.10.31 17:40,s/l,154,0.10,1.11564,1.11564,1.10564,-25.00,1000107.91
464,2019.11.05 17:05,t/p,155,0.10,1.10822,1.11822,1.10822,75.09,1000183.00
467,2019.11.12 17:40,t/p,156,0.10,1.10062,1.11062,1.10062,75.20,1000258.20
470,2019.11.15 15:40,s/l,157,0.10,1.10377,1.10377,1.09377,-24.86,1000233.35
473,2019.11.25 11:37,s/l,158,0.10,1.10129,1.10129,1.11129,-30.10,1000203.25
476,2019.12.02 16:05,s/l,159,0.10,1.10375,1.10375,1.09375,-24.80,1000178.45
479,2019.12.11 21:50,t/p,160,0.10,1.11247,1.10247,1.11247,69.27,1000247.72
482,2019.12.12 20:10,s/l,161,0.10,1.11059,1.11059,1.12059,-26.91,1000220.81
485,2019.12.12 22:40,s/l,162,0.10,1.11280,1.11280,1.10280,-25.00,1000195.81
488,2019.12.13 00:07,s/l,163,0.10,1.11525,1.11525,1.10525,-24.97,1000170.84
491,2019.12.13 00:22,s/l,164,0.10,1.11833,1.11833,1.10833,-25.00,1000145.84
494,2019.12.19 17:25,t/p,165,0.10,1.11099,1.12099,1.11099,75.17,1000221.01
497,2019.12.27 10:01,s/l,166,0.10,1.11322,1.11322,1.10322,-24.77,1000196.24
500,2019.12.30 05:16,t/p,167,0.10,1.12092,1.11092,1.12092,74.36,1000270.61
503,2020.01.02 16:40,s/l,168,0.10,1.11728,1.11728,1.12728,-28.18,1000242.42
506,2020.01.02 17:52,s/l,169,0.10,1.11961,1.11961,1.10961,-25.00,1000217.42
509,2020.01.08 13:16,t/p,170,0.10,1.11213,1.12213,1.11213,75.12,1000292.54
512,2020.01.13 18:31,s/l,171,0.10,1.11456,1.11456,1.10456,-24.86,1000267.68
515,2020.01.14 14:16,s/l,172,0.10,1.11217,1.11217,1.12217,-25.64,1000242.05
518,2020.01.15 13:05,s/l,173,0.10,1.11449,1.11449,1.10449,-24.97,1000217.07
521,2020.01.16 17:22,s/l,174,0.10,1.11358,1.11358,1.12358,-26.91,1000190.16
524,2020.01.23 16:25,t/p,175,0.10,1.10625,1.11625,1.10625,75.20,1000265.37
527,2020.01.29 15:23,t/p,176,0.10,1.09951,1.10951,1.09951,75.12,1000340.48
530,2020.01.29 21:55,s/l,177,0.10,1.10193,1.10193,1.09193,-25.00,1000315.48
533,2020.02.05 17:53,s/l,178,0.10,1.09965,1.09965,1.10965,-29.46,1000286.02
536,2020.02.10 17:55,t/p,179,0.10,1.09213,1.10213,1.09213,75.14,1000361.17
539,2020.02.13 16:10,t/p,180,0.10,1.08489,1.09489,1.08489,75.14,1000436.31
542,2020.02.20 09:23,t/p,181,0.10,1.07786,1.08786,1.07786,75.20,1000511.52
545,2020.02.20 11:22,s/l,182,0.10,1.08025,1.08025,1.07025,-25.00,1000486.52
548,2020.02.21 16:46,s/l,183,0.10,1.08280,1.08280,1.07280,-24.97,1000461.55
551,2020.02.26 14:08,t/p,184,0.10,1.09046,1.08046,1.09046,73.09,1000534.63
554,2020.02.26 14:35,s/l,185,0.10,1.08844,1.08844,1.09844,-25.00,1000509.63
557,2020.02.26 15:55,s/l,186,0.10,1.08577,1.08577,1.09577,-25.00,1000484.63
560,2020.02.26 21:40,s/l,187,0.10,1.08979,1.08979,1.07979,-25.00,1000459.63
563,2020.02.27 15:55,t/p,188,0.10,1.09752,1.08752,1.09752,73.09,1000532.72
566,2020.02.28 16:40,s/l,189,0.10,1.09533,1.09533,1.10533,-25.64,1000507.09
569,2020.02.28 17:50,s/l,190,0.10,1.09764,1.09764,1.08764,-25.00,1000482.09
572,2020.02.28 18:10,s/l,191,0.10,1.10022,1.10022,1.09022,-25.00,1000457.09
575,2020.02.28 21:40,s/l,192,0.10,1.10273,1.10273,1.09273,-25.00,1000432.09
578,2020.03.02 13:52,t/p,193,0.10,1.11084,1.10084,1.11084,74.36,1000506.45
581,2020.03.03 17:22,t/p,194,0.10,1.11941,1.10941,1.11941,74.36,1000580.81
584,2020.03.03 17:40,s/l,195,0.10,1.11780,1.11780,1.12780,-25.00,1000555.81
587,2020.03.03 18:10,s/l,196,0.10,1.11554,1.11554,1.12554,-25.00,1000530.81
590,2020.03.04 14:35,s/l,197,0.10,1.11308,1.11308,1.12308,-25.64,1000505.18
593,2020.03.05 11:25,s/l,198,0.10,1.11543,1.11543,1.10543,-24.91,1000480.26
596,2020.03.06 03:55,t/p,199,0.10,1.12457,1.11457,1.12457,74.36,1000554.63
599,2020.03.06 08:40,s/l,200,0.10,1.12213,1.12213,1.13213,-25.00,1000529.63
602,2020.03.06 17:25,s/l,201,0.10,1.12920,1.12920,1.13920,-25.00,1000504.63
605,2020.03.09 00:37,t/p,202,0.10,1.13628,1.12628,1.13628,74.36,1000578.99
608,2020.03.09 03:50,t/p,203,0.10,1.14357,1.13357,1.14357,75.00,1000653.99
611,2020.03.09 04:03,s/l,204,0.10,1.14180,1.14180,1.15180,-25.00,1000628.99
614,2020.03.09 04:55,s/l,205,0.10,1.13896,1.13896,1.14896,-25.00,1000603.99
617,2020.03.09 09:25,t/p,206,0.10,1.14618,1.13618,1.14618,75.00,1000678.99
620,2020.03.09 10:16,s/l,207,0.10,1.14138,1.14138,1.15138,-25.00,1000653.99
623,2020.03.09 11:07,s/l,208,0.10,1.13885,1.13885,1.14885,-25.00,1000628.99
626,2020.03.09 15:52,s/l,209,0.10,1.14109,1.14109,1.15109,-25.00,1000603.99
629,2020.03.10 01:37,s/l,210,0.10,1.14142,1.14142,1.15142,-25.64,1000578.35
632,2020.03.10 07:55,t/p,211,0.10,1.13347,1.14347,1.13347,75.00,1000653.35
635,2020.03.10 08:07,s/l,212,0.10,1.13565,1.13565,1.12565,-25.00,1000628.35
638,2020.03.10 10:05,s/l,213,0.10,1.13886,1.13886,1.12886,-25.00,1000603.35
641,2020.03.10 14:25,s/l,214,0.10,1.13846,1.13846,1.12846,-25.00,1000578.35
644,2020.03.10 16:10,s/l,215,0.10,1.13587,1.13587,1.14587,-25.00,1000553.35
647,2020.03.10 20:40,t/p,216,0.10,1.12957,1.13957,1.12957,75.00,1000628.35
650,2020.03.11 01:53,s/l,217,0.10,1.13217,1.13217,1.12217,-24.97,1000603.38
653,2020.03.11 07:10,s/l,218,0.10,1.13479,1.13479,1.12479,-25.00,1000578.38
656,2020.03.11 10:07,s/l,219,0.10,1.13236,1.13236,1.14236,-25.00,1000553.38
659,2020.03.12 03:20,s/l,220,0.10,1.13095,1.13095,1.12095,-24.91,1000528.47
662,2020.03.12 06:25,s/l,221,0.10,1.12943,1.12943,1.13943,-25.00,1000503.47
665,2020.03.12 10:25,s/l,222,0.10,1.12688,1.12688,1.13688,-25.00,1000478.47
668,2020.03.12 11:55,s/l,223,0.10,1.12398,1.12398,1.13398,-25.00,1000453.47
671,2020.03.12 14:52,s/l,224,0.10,1.12621,1.12621,1.11621,-25.00,1000428.47
674,2020.03.12 14:55,s/l,225,0.10,1.12979,1.12979,1.11979,-25.00,1000403.47
677,2020.03.12 14:59,t/p,226,0.10,1.12261,1.13261,1.12261,75.00,1000478.47
680,2020.03.12 15:07,s/l,227,0.10,1.12401,1.12401,1.11401,-25.00,1000453.47
683,2020.03.12 16:08,t/p,228,0.10,1.11665,1.12665,1.11665,75.00,1000528.47
686,2020.03.12 16:13,s/l,229,0.10,1.11569,1.11569,1.10569,-25.00,1000503.47
689,2020.03.12 17:38,t/p,230,0.10,1.10958,1.11958,1.10958,75.00,1000578.47
692,2020.03.12 18:50,s/l,231,0.10,1.11147,1.11147,1.10147,-25.00,1000553.47
695,2020.03.12 18:55,s/l,232,0.10,1.11490,1.11490,1.10490,-25.00,1000528.47
698,2020.03.12 19:31,s/l,233,0.10,1.11889,1.11889,1.10889,-25.00,1000503.47
701,2020.03.12 22:16,s/l,234,0.10,1.12196,1.12196,1.11196,-25.00,1000478.47
704,2020.03.13 13:45,t/p,235,0.10,1.11460,1.12460,1.11460,75.03,1000553.50
707,2020.03.13 14:07,s/l,236,0.10,1.11702,1.11702,1.10702,-25.00,1000528.50
710,2020.03.13 16:40,t/p,237,0.10,1.11015,1.12015,1.11015,75.00,1000603.50
713,2020.03.16 00:00,s/l,238,0.10,1.11239,1.11239,1.10239,-24.97,1000578.53
716,2020.03.16 02:38,s/l,239,0.10,1.11321,1.11321,1.12321,-25.00,1000553.53
719,2020.03.16 03:25,s/l,240,0.10,1.10929,1.10929,1.11929,-25.00,1000528.53
722,2020.03.16 07:10,s/l,241,0.10,1.11088,1.11088,1.12088,-25.00,1000503.53
725,2020.03.16 10:07,t/p,242,0.10,1.11835,1.10835,1.11835,75.00,1000578.53
728,2020.03.16 12:22,s/l,243,0.10,1.11629,1.11629,1.12629,-25.00,1000553.53
731,2020.03.16 15:22,s/l,244,0.10,1.11375,1.11375,1.12375,-25.00,1000528.53
734,2020.03.16 15:33,s/l,245,0.10,1.11110,1.11110,1.12110,-25.00,1000503.53
737,2020.03.16 17:20,s/l,246,0.10,1.11270,1.11270,1.10270,-25.00,1000478.53
740,2020.03.16 18:07,s/l,247,0.10,1.11522,1.11522,1.10522,-25.00,1000453.53
743,2020.03.16 22:20,s/l,248,0.10,1.11783,1.11783,1.10783,-25.00,1000428.53
746,2020.03.16 23:25,s/l,249,0.10,1.11611,1.11611,1.12611,-25.00,1000403.53
749,2020.03.17 09:40,s/l,250,0.10,1.11310,1.11310,1.12310,-25.64,1000377.89
752,2020.03.17 12:40,t/p,251,0.10,1.10544,1.11544,1.10544,75.00,1000452.89
755,2020.03.17 14:40,t/p,252,0.10,1.09743,1.10743,1.09743,75.00,1000527.89
758,2020.03.17 15:37,s/l,253,0.10,1.09981,1.09981,1.08981,-25.00,1000502.89
761,2020.03.18 05:55,s/l,254,0.10,1.10285,1.10285,1.09285,-24.97,1000477.92
764,2020.03.18 08:55,s/l,255,0.10,1.10031,1.10031,1.11031,-25.00,1000452.92
767,2020.03.18 15:25,t/p,256,0.10,1.09250,1.10250,1.09250,75.00,1000527.92
770,2020.03.18 17:52,t/p,257,0.10,1.08457,1.09457,1.08457,75.00,1000602.92
773,2020.03.18 20:25,s/l,258,0.10,1.08710,1.08710,1.07710,-25.00,1000577.92
776,2020.03.18 22:07,s/l,259,0.10,1.09072,1.09072,1.08072,-25.00,1000552.92
779,2020.03.19 00:55,s/l,260,0.10,1.09321,1.09321,1.08321,-24.91,1000528.00
782,2020.03.19 02:52,s/l,261,0.10,1.09091,1.09091,1.10091,-25.00,1000503.00
785,2020.03.19 04:55,s/l,262,0.10,1.08834,1.08834,1.09834,-25.00,1000478.00
788,2020.03.19 10:10,t/p,263,0.10,1.08165,1.09165,1.08165,75.00,1000553.00
791,2020.03.19 11:31,s/l,264,0.10,1.08624,1.08624,1.07624,-25.00,1000528.00
794,2020.03.19 12:55,t/p,265,0.10,1.07903,1.08903,1.07903,75.00,1000603.00
797,2020.03.19 14:52,s/l,266,0.10,1.08074,1.08074,1.07074,-25.00,1000578.00
800,2020.03.19 17:50,t/p,267,0.10,1.07421,1.08421,1.07421,75.00,1000653.00
803,2020.03.19 18:55,t/p,268,0.10,1.06616,1.07616,1.06616,75.00,1000728.00
806,2020.03.19 19:10,s/l,269,0.10,1.06852,1.06852,1.05852,-25.00,1000703.00
809,2020.03.19 22:40,s/l,270,0.10,1.07046,1.07046,1.06046,-25.00,1000678.00
812,2020.03.20 03:52,s/l,271,0.10,1.07296,1.07296,1.06296,-24.97,1000653.03
815,2020.03.20 05:10,s/l,272,0.10,1.07204,1.07204,1.08204,-25.00,1000628.03
818,2020.03.20 09:37,t/p,273,0.10,1.07917,1.06917,1.07917,75.00,1000703.03
821,2020.03.20 11:10,s/l,274,0.10,1.07744,1.07744,1.08744,-25.00,1000678.03
824,2020.03.20 11:37,s/l,275,0.10,1.07471,1.07471,1.08471,-25.00,1000653.03
827,2020.03.20 11:55,s/l,276,0.10,1.07207,1.07207,1.08207,-25.00,1000628.03
830,2020.03.20 15:20,s/l,277,0.10,1.06905,1.06905,1.07905,-25.00,1000603.03
833,2020.03.20 15:40,s/l,278,0.10,1.07132,1.07132,1.06132,-25.00,1000578.03
836,2020.03.20 16:25,s/l,279,0.10,1.07451,1.07451,1.06451,-25.00,1000553.03
839,2020.03.20 17:55,t/p,280,0.10,1.06743,1.07743,1.06743,75.00,1000628.03
842,2020.03.20 18:10,s/l,281,0.10,1.07080,1.07080,1.06080,-25.00,1000603.03
845,2020.03.20 20:40,t/p,282,0.10,1.06389,1.07389,1.06389,75.00,1000678.03
848,2020.03.20 21:52,s/l,283,0.10,1.06650,1.06650,1.05650,-25.00,1000653.03
851,2020.03.20 22:38,s/l,284,0.10,1.06918,1.06918,1.05918,-25.00,1000628.03
854,2020.03.23 01:10,s/l,285,0.10,1.06801,1.06801,1.05801,-25.00,1000603.03
857,2020.03.23 02:18,s/l,286,0.10,1.07046,1.07046,1.06046,-25.00,1000578.03
860,2020.03.23 09:55,s/l,287,0.10,1.06927,1.06927,1.07927,-25.00,1000553.03
863,2020.03.23 14:20,t/p,288,0.10,1.07650,1.06650,1.07650,75.00,1000628.03
866,2020.03.23 14:25,s/l,289,0.10,1.07951,1.07951,1.06951,-25.00,1000603.03
869,2020.03.23 16:48,s/l,290,0.10,1.08271,1.08271,1.07271,-25.00,1000578.03
872,2020.03.23 17:35,s/l,291,0.10,1.07796,1.07796,1.08796,-25.00,1000553.03
875,2020.03.23 18:07,s/l,292,0.10,1.07502,1.07502,1.08502,-25.00,1000528.03
878,2020.03.23 18:40,s/l,293,0.10,1.07244,1.07244,1.08244,-25.00,1000503.03
881,2020.03.24 02:52,t/p,294,0.10,1.07997,1.06997,1.07997,74.36,1000577.40
884,2020.03.24 12:07,t/p,295,0.10,1.08692,1.07692,1.08692,75.00,1000652.40
887,2020.03.24 14:10,s/l,296,0.10,1.08407,1.08407,1.09407,-25.00,1000627.40
890,2020.03.24 15:40,s/l,297,0.10,1.08046,1.08046,1.09046,-25.00,1000602.40
893,2020.03.24 19:37,s/l,298,0.10,1.07644,1.07644,1.08644,-25.00,1000577.40
896,2020.03.24 22:40,s/l,299,0.10,1.07870,1.07870,1.06870,-25.00,1000552.40
899,2020.03.25 00:55,s/l,300,0.10,1.08141,1.08141,1.07141,-24.97,1000527.43
902,2020.03.25 02:46,s/l,301,0.10,1.07733,1.07733,1.08733,-25.00,1000502.43
905,2020.03.25 20:20,t/p,302,0.10,1.08728,1.07728,1.08728,75.00,1000577.43
908,2020.03.26 11:40,t/p,303,0.10,1.09496,1.08496,1.09496,73.09,1000650.51
911,2020.03.26 21:52,t/p,304,0.10,1.10478,1.09478,1.10478,75.00,1000725.51
914,2020.03.26 23:18,s/l,305,0.10,1.10239,1.10239,1.11239,-25.00,1000700.51
917,2020.03.27 11:25,s/l,306,0.10,1.09995,1.09995,1.10995,-25.64,1000674.88
920,2020.03.27 11:48,s/l,307,0.10,1.10184,1.10184,1.09184,-25.00,1000649.88
923,2020.03.27 17:40,s/l,308,0.10,1.10437,1.10437,1.09437,-25.00,1000624.88
926,2020.03.27 22:15,t/p,309,0.10,1.11347,1.10347,1.11347,75.00,1000699.88
929,2020.03.30 00:07,s/l,310,0.10,1.11141,1.11141,1.12141,-25.64,1000674.24
932,2020.03.30 05:10,s/l,311,0.10,1.10874,1.10874,1.11874,-25.00,1000649.24
935,2020.03.30 08:55,s/l,312,0.10,1.11024,1.11024,1.10024,-25.00,1000624.24
938,2020.03.30 15:50,t/p,313,0.10,1.10275,1.11275,1.10275,75.00,1000699.24
941,2020.03.30 22:55,s/l,314,0.10,1.10510,1.10510,1.09510,-25.00,1000674.24
944,2020.03.31 00:01,s/l,315,0.10,1.10286,1.10286,1.11286,-25.64,1000648.60
947,2020.03.31 03:50,s/l,316,0.10,1.10240,1.10240,1.11240,-25.00,1000623.60
950,2020.03.31 13:55,t/p,317,0.10,1.09485,1.10485,1.09485,75.00,1000698.60
953,2020.03.31 15:40,s/l,318,0.10,1.09726,1.09726,1.08726,-25.00,1000673.60
956,2020.03.31 18:25,s/l,319,0.10,1.10037,1.10037,1.09037,-25.00,1000648.60
959,2020.03.31 22:55,s/l,320,0.10,1.10307,1.10307,1.09307,-25.00,1000623.60
962,2020.04.01 05:10,s/l,321,0.10,1.10076,1.10076,1.11076,-25.64,1000597.97
965,2020.04.01 09:40,s/l,322,0.10,1.09888,1.09888,1.10888,-25.00,1000572.97
968,2020.04.01 20:25,t/p,323,0.10,1.09121,1.10121,1.09121,75.00,1000647.97
971,2020.04.02 05:52,s/l,324,0.10,1.09350,1.09350,1.10350,-26.91,1000621.06
974,2020.04.02 09:10,s/l,325,0.10,1.09628,1.09628,1.08628,-25.00,1000596.06
977,2020.04.02 11:05,s/l,326,0.10,1.09303,1.09303,1.10303,-25.00,1000571.06
980,2020.04.02 16:55,t/p,327,0.10,1.08442,1.09442,1.08442,75.00,1000646.06
983,2020.04.02 17:07,s/l,328,0.10,1.08654,1.08654,1.07654,-25.00,1000621.06
986,2020.04.02 17:40,s/l,329,0.10,1.08900,1.08900,1.07900,-25.00,1000596.06
989,2020.04.02 21:01,t/p,330,0.10,1.08251,1.09251,1.08251,75.00,1000671.06
992,2020.04.02 21:55,s/l,331,0.10,1.08484,1.08484,1.07484,-25.00,1000646.06
995,2020.04.03 15:55,t/p,332,0.10,1.07765,1.08765,1.07765,75.03,1000721.08
998,2020.04.03 17:55,s/l,333,0.10,1.08004,1.08004,1.07004,-25.00,1000696.08
1001,2020.04.06 11:40,s/l,334,0.10,1.07907,1.07907,1.08907,-25.64,1000670.45
1004,2020.04.06 12:55,s/l,335,0.10,1.08119,1.08119,1.07119,-25.00,1000645.45
1007,2020.04.07 07:52,s/l,336,0.10,1.08278,1.08278,1.07278,-24.97,1000620.48
1010,2020.04.07 15:22,t/p,337,0.10,1.09034,1.08034,1.09034,75.00,1000695.48
1013,2020.04.07 17:55,s/l,338,0.10,1.08827,1.08827,1.09827,-25.00,1000670.48
1016,2020.04.08 03:37,s/l,339,0.10,1.08778,1.08778,1.09778,-25.64,1000644.84
1019,2020.04.09 15:52,s/l,340,0.10,1.09015,1.09015,1.08015,-24.91,1000619.93
1022,2020.04.14 17:18,t/p,341,0.10,1.09767,1.08767,1.09767,73.09,1000693.02
1025,2020.04.15 10:20,s/l,342,0.10,1.09525,1.09525,1.10525,-25.64,1000667.38
1028,2020.04.15 15:37,t/p,343,0.10,1.08772,1.09772,1.08772,75.00,1000742.38
1031,2020.04.15 17:50,s/l,344,0.10,1.08998,1.08998,1.07998,-25.00,1000717.38
1034,2020.04.15 19:46,s/l,345,0.10,1.09260,1.09260,1.08260,-25.00,1000692.38
1037,2020.04.16 13:10,t/p,346,0.10,1.08542,1.09542,1.08542,75.09,1000767.47
1040,2020.04.16 17:40,s/l,347,0.10,1.08687,1.08687,1.09687,-25.00,1000742.47
1043,2020.04.17 02:18,s/l,348,0.10,1.08657,1.08657,1.07657,-24.97,1000717.49
1046,2020.04.17 10:10,s/l,349,0.10,1.08383,1.08383,1.09383,-25.00,1000692.49
1049,2020.04.17 15:07,s/l,350,0.10,1.08537,1.08537,1.07537,-25.00,1000667.49
1052,2020.04.17 16:53,s/l,351,0.10,1.08833,1.08833,1.07833,-25.00,1000642.49
1055,2020.04.17 19:31,s/l,352,0.10,1.08641,1.08641,1.09641,-25.00,1000617.49
1058,2020.04.21 05:20,s/l,353,0.10,1.08359,1.08359,1.09359,-26.27,1000591.22
1061,2020.04.21 16:52,s/l,354,0.10,1.08580,1.08580,1.07580,-25.00,1000566.22
1064,2020.04.21 17:40,s/l,355,0.10,1.08445,1.08445,1.09445,-25.00,1000541.22
1067,2020.04.22 19:22,s/l,356,0.10,1.08190,1.08190,1.09190,-25.64,1000515.58
1070,2020.04.23 17:25,s/l,357,0.10,1.08421,1.08421,1.07421,-24.91,1000490.67
1073,2020.04.23 20:55,t/p,358,0.10,1.07716,1.08716,1.07716,75.00,1000565.67
1076,2020.04.24 14:16,s/l,359,0.10,1.08035,1.08035,1.07035,-25.00,1000540.67
1079,2020.04.28 12:37,t/p,360,0.10,1.08782,1.07782,1.08782,73.73,1000614.40
1082,2020.04.28 16:40,s/l,361,0.10,1.08561,1.08561,1.09561,-25.00,1000589.40
1085,2020.04.28 18:01,s/l,362,0.10,1.08297,1.08297,1.09297,-25.00,1000564.40
1088,2020.04.29 10:10,s/l,363,0.10,1.08642,1.08642,1.07642,-24.97,1000539.43
1091,2020.04.29 14:10,s/l,364,0.10,1.08440,1.08440,1.09440,-25.00,1000514.43
1094,2020.04.30 17:50,t/p,365,0.10,1.09192,1.08192,1.09192,73.09,1000587.51
1097,2020.05.01 17:40,t/p,366,0.10,1.10127,1.09127,1.10127,74.36,1000661.88
1100,2020.05.01 19:10,s/l,367,0.10,1.09937,1.09937,1.10937,-25.00,1000636.88
1103,2020.05.05 10:07,t/p,368,0.10,1.08961,1.09961,1.08961,75.03,1000711.91
1106,2020.05.05 11:10,s/l,369,0.10,1.09234,1.09234,1.08234,-25.00,1000686.91
1109,2020.05.05 11:52,t/p,370,0.10,1.08507,1.09507,1.08507,75.00,1000761.91
1112,2020.05.05 13:10,s/l,371,0.10,1.08555,1.08555,1.07555,-25.00,1000736.91
1115,2020.05.05 16:50,s/l,372,0.10,1.08815,1.08815,1.07815,-25.00,1000711.91
1118,2020.05.06 11:22,t/p,373,0.10,1.08058,1.09058,1.08058,75.03,1000786.94
1121,2020.05.06 14:46,s/l,374,0.10,1.08156,1.08156,1.07156,-25.00,1000761.94
1124,2020.05.08 01:22,s/l,375,0.10,1.08401,1.08401,1.07401,-24.88,1000737.05
1127,2020.05.08 17:05,s/l,376,0.10,1.08152,1.08152,1.09152,-25.00,1000712.05
1130,2020.05.11 11:38,s/l,377,0.10,1.08132,1.08132,1.09132,-25.64,1000686.41
1133,2020.05.11 16:16,s/l,378,0.10,1.08338,1.08338,1.07338,-25.00,1000661.41
1136,2020.05.12 15:10,s/l,379,0.10,1.08602,1.08602,1.07602,-24.97,1000636.44
1139,2020.05.13 10:40,s/l,380,0.10,1.08357,1.08357,1.09357,-25.64,1000610.81
1142,2020.05.13 13:40,s/l,381,0.10,1.08578,1.08578,1.07578,-25.00,1000585.81
1145,2020.05.13 17:52,s/l,382,0.10,1.08491,1.08491,1.09491,-25.00,1000560.81
1148,2020.05.13 19:55,s/l,383,0.10,1.08196,1.08196,1.09196,-25.00,1000535.81
1151,2020.05.15 16:10,s/l,384,0.10,1.08460,1.08460,1.07460,-24.88,1000510.92
1154,2020.05.15 17:55,s/l,385,0.10,1.08163,1.08163,1.09163,-25.00,1000485.92
1157,2020.05.18 18:22,t/p,386,0.10,1.08897,1.07897,1.08897,74.36,1000560.29
1160,2020.05.19 13:40,t/p,387,0.10,1.09666,1.08666,1.09666,74.36,1000634.65
1163,2020.05.19 14:53,s/l,388,0.10,1.09445,1.09445,1.10445,-25.00,1000609.65
1166,2020.05.19 23:10,s/l,389,0.10,1.09191,1.09191,1.10191,-25.00,1000584.65
1169,2020.05.20 04:25,s/l,390,0.10,1.09435,1.09435,1.08435,-24.97,1000559.68
1172,2020.05.22 10:51,s/l,391,0.10,1.09127,1.09127,1.10127,-27.55,1000532.13
1175,2020.05.26 10:18,s/l,392,0.10,1.09373,1.09373,1.08373,-24.94,1000507.19
1178,2020.05.27 12:52,t/p,393,0.10,1.10128,1.09128,1.10128,74.36,1000581.55
1181,2020.05.27 15:07,s/l,394,0.10,1.09948,1.09948,1.10948,-25.00,1000556.55
1184,2020.05.27 18:01,s/l,395,0.10,1.09694,1.09694,1.10694,-25.00,1000531.55
1187,2020.05.27 22:37,s/l,396,0.10,1.09997,1.09997,1.08997,-25.00,1000506.55
1190,2020.05.28 19:31,t/p,397,0.10,1.10809,1.09809,1.10809,75.00,1000581.55
1193,2020.06.02 11:25,t/p,398,0.10,1.11577,1.10577,1.11577,73.09,1000654.64
1196,2020.06.02 17:01,s/l,399,0.10,1.11911,1.11911,1.10911,-25.00,1000629.64
1199,2020.06.02 18:52,s/l,400,0.10,1.11695,1.11695,1.12695,-25.00,1000604.64
1202,2020.06.04 14:55,t/p,401,0.10,1.12687,1.11687,1.12687,73.09,1000677.73
1205,2020.06.04 17:25,s/l,402,0.10,1.12971,1.12971,1.11971,-25.00,1000652.73
1208,2020.06.05 09:01,t/p,403,0.10,1.13759,1.12759,1.13759,74.36,1000727.09
1211,2020.06.05 15:37,s/l,404,0.10,1.13078,1.13078,1.14078,-25.00,1000702.09
1214,2020.06.09 16:40,s/l,405,0.10,1.13290,1.13290,1.12290,-24.94,1000677.15
1217,2020.06.10 21:05,s/l,406,0.10,1.13244,1.13244,1.14244,-25.64,1000651.51
1220,2020.06.11 07:10,s/l,407,0.10,1.13510,1.13510,1.14510,-25.00,1000626.51
1223,2020.06.11 10:55,s/l,408,0.10,1.13721,1.13721,1.12721,-25.00,1000601.51
1226,2020.06.11 12:40,s/l,409,0.10,1.13978,1.13978,1.12978,-25.00,1000576.51
1229,2020.06.11 15:10,s/l,410,0.10,1.13481,1.13481,1.14481,-25.00,1000551.51
1232,2020.06.11 20:08,s/l,411,0.10,1.13444,1.13444,1.14444,-25.00,1000526.51
1235,2020.06.12 17:50,t/p,412,0.10,1.12624,1.13624,1.12624,75.03,1000601.54
1238,2020.06.15 16:55,s/l,413,0.10,1.12835,1.12835,1.11835,-24.97,1000576.57
1241,2020.06.16 10:03,t/p,414,0.10,1.13529,1.12529,1.13529,74.36,1000650.93
1244,2020.06.16 17:40,t/p,415,0.10,1.12405,1.13405,1.12405,75.00,1000725.93
1247,2020.06.16 18:31,s/l,416,0.10,1.12627,1.12627,1.11627,-25.00,1000700.93
1250,2020.06.17 10:10,s/l,417,0.10,1.12879,1.12879,1.11879,-24.97,1000675.96
1253,2020.06.17 11:07,s/l,418,0.10,1.12651,1.12651,1.13651,-25.00,1000650.96
1256,2020.06.19 17:55,t/p,419,0.10,1.11734,1.12734,1.11734,75.12,1000726.08
1259,2020.06.22 16:55,t/p,420,0.10,1.12438,1.11438,1.12438,74.36,1000800.44
1262,2020.06.23 15:22,t/p,421,0.10,1.13219,1.12219,1.13219,74.36,1000874.80
1265,2020.06.24 10:25,s/l,422,0.10,1.12988,1.12988,1.13988,-25.64,1000849.17
1268,2020.06.25 12:40,t/p,423,0.10,1.12231,1.13231,1.12231,75.09,1000924.25
1271,2020.06.25 16:55,s/l,424,0.10,1.12215,1.12215,1.11215,-25.00,1000899.25
1274,2020.06.29 05:40,s/l,425,0.10,1.12466,1.12466,1.11466,-24.94,1000874.31
1277,2020.06.30 09:10,s/l,426,0.10,1.12161,1.12161,1.13161,-25.64,1000848.68
1280,2020.06.30 18:05,s/l,427,0.10,1.12392,1.12392,1.11392,-25.00,1000823.68
1283,2020.07.01 12:59,s/l,428,0.10,1.12127,1.12127,1.13127,-25.64,1000798.04
1286,2020.07.01 16:40,s/l,429,0.10,1.12326,1.12326,1.11326,-25.00,1000773.04
1289,2020.07.01 17:10,s/l,430,0.10,1.12576,1.12576,1.11576,-25.00,1000748.04
1292,2020.07.02 17:40,s/l,431,0.10,1.12353,1.12353,1.13353,-26.91,1000721.13
1295,2020.07.06 03:07,s/l,432,0.10,1.12586,1.12586,1.11586,-24.94,1000696.19
1298,2020.07.06 16:03,t/p,433,0.10,1.13336,1.12336,1.13336,75.00,1000771.19
1301,2020.07.07 10:10,s/l,434,0.10,1.12896,1.12896,1.13896,-25.64,1000745.55
1304,2020.07.08 16:36,s/l,435,0.10,1.13140,1.13140,1.12140,-24.97,1000720.58
1307,2020.07.09 17:55,s/l,436,0.10,1.12918,1.12918,1.13918,-26.91,1000693.67
1310,2020.07.10 16:40,s/l,437,0.10,1.13150,1.13150,1.12150,-24.97,1000668.70
1313,2020.07.14 16:55,t/p,438,0.10,1.13903,1.12903,1.13903,73.73,1000742.42
1316,2020.07.21 06:25,t/p,439,0.10,1.14691,1.13691,1.14691,70.54,1000812.96
1319,2020.07.21 06:53,s/l,440,0.10,1.14438,1.14438,1.15438,-25.00,1000787.96
1322,2020.07.21 19:33,t/p,441,0.10,1.15160,1.14160,1.15160,75.00,1000862.96
1325,2020.07.22 15:25,t/p,442,0.10,1.15917,1.14917,1.15917,74.36,1000937.33
1328,2020.07.23 15:10,s/l,443,0.10,1.15612,1.15612,1.16612,-26.91,1000910.41
1331,2020.07.23 16:55,s/l,444,0.10,1.15852,1.15852,1.14852,-25.00,1000885.41
1334,2020.07.23 18:40,s/l,445,0.10,1.16117,1.16117,1.15117,-25.00,1000860.41
1337,2020.07.27 03:35,t/p,446,0.10,1.16796,1.15796,1.16796,73.73,1000934.14
1340,2020.07.27 17:37,t/p,447,0.10,1.17680,1.16680,1.17680,75.00,1001009.14
1343,2020.07.27 18:55,s/l,448,0.10,1.17527,1.17527,1.18527,-25.00,1000984.14
1346,2020.07.28 06:52,s/l,449,0.10,1.17260,1.17260,1.18260,-25.64,1000958.50
1349,2020.07.29 09:37,s/l,450,0.10,1.17466,1.17466,1.16466,-24.97,1000933.53
1352,2020.07.29 14:55,s/l,451,0.10,1.17225,1.17225,1.18225,-25.00,1000908.53
1355,2020.07.30 20:15,t/p,452,0.10,1.18195,1.17195,1.18195,73.09,1000981.62
1358,2020.07.31 05:37,t/p,453,0.10,1.18974,1.17974,1.18974,74.36,1001055.98
1361,2020.07.31 19:37,t/p,454,0.10,1.17819,1.18819,1.17819,75.00,1001130.98
1364,2020.07.31 20:07,s/l,455,0.10,1.17981,1.17981,1.16981,-25.00,1001105.98
1367,2020.08.03 13:25,t/p,456,0.10,1.17229,1.18229,1.17229,75.03,1001181.01
1370,2020.08.03 20:10,s/l,457,0.10,1.17559,1.17559,1.16559,-25.00,1001156.01
1373,2020.08.04 15:52,s/l,458,0.10,1.17311,1.17311,1.18311,-25.64,1001130.38
1376,2020.08.04 17:37,s/l,459,0.10,1.17525,1.17525,1.16525,-25.00,1001105.38
1379,2020.08.04 19:59,s/l,460,0.10,1.17783,1.17783,1.16783,-25.00,1001080.38
1382,2020.08.05 12:52,t/p,461,0.10,1.18576,1.17576,1.18576,74.36,1001154.74
1385,2020.08.06 10:52,s/l,462,0.10,1.18533,1.18533,1.19533,-26.91,1001127.83
1388,2020.08.06 19:05,s/l,463,0.10,1.18731,1.18731,1.17731,-25.00,1001102.83
1391,2020.08.07 05:25,s/l,464,0.10,1.18499,1.18499,1.19499,-25.64,1001077.19
1394,2020.08.07 16:25,t/p,465,0.10,1.17716,1.18716,1.17716,75.00,1001152.19
1397,2020.08.07 18:01,s/l,466,0.10,1.17930,1.17930,1.16930,-25.00,1001127.19
1400,2020.08.12 05:08,t/p,467,0.10,1.17204,1.18204,1.17204,75.09,1001202.28
1403,2020.08.12 10:37,s/l,468,0.10,1.17426,1.17426,1.16426,-25.00,1001177.28
1406,2020.08.13 09:10,t/p,469,0.10,1.18241,1.17241,1.18241,73.09,1001250.37
1409,2020.08.13 21:20,s/l,470,0.10,1.18035,1.18035,1.19035,-25.00,1001225.37
1412,2020.08.14 15:40,s/l,471,0.10,1.18283,1.18283,1.17283,-24.97,1001200.40
1415,2020.08.14 17:18,s/l,472,0.10,1.18106,1.18106,1.19106,-25.00,1001175.40
1418,2020.08.18 03:50,t/p,473,0.10,1.18858,1.17858,1.18858,73.73,1001249.12
1421,2020.08.19 19:25,s/l,474,0.10,1.18658,1.18658,1.19658,-25.64,1001223.49
1424,2020.08.19 21:03,s/l,475,0.10,1.18901,1.18901,1.17901,-25.00,1001198.49
1427,2020.08.20 11:25,t/p,476,0.10,1.18188,1.19188,1.18188,75.09,1001273.57
1430,2020.08.20 18:37,s/l,477,0.10,1.18577,1.18577,1.17577,-25.00,1001248.57
1433,2020.08.21 10:40,s/l,478,0.10,1.18333,1.18333,1.19333,-25.64,1001222.94
1436,2020.08.21 16:53,t/p,479,0.10,1.17575,1.18575,1.17575,75.00,1001297.94
1439,2020.08.21 17:25,s/l,480,0.10,1.17796,1.17796,1.16796,-25.00,1001272.94
1442,2020.08.24 02:20,s/l,481,0.10,1.18045,1.18045,1.17045,-24.97,1001247.96
1445,2020.08.26 15:25,s/l,482,0.10,1.17815,1.17815,1.18815,-26.27,1001221.69
1448,2020.08.26 17:20,s/l,483,0.10,1.18214,1.18214,1.17214,-25.00,1001196.69
1451,2020.08.27 14:08,s/l,484,0.10,1.17969,1.17969,1.18969,-26.91,1001169.78
1454,2020.08.27 14:55,s/l,485,0.10,1.18189,1.18189,1.17189,-25.00,1001144.78
1457,2020.08.27 16:05,s/l,486,0.10,1.18436,1.18436,1.17436,-25.00,1001119.78
1460,2020.08.27 18:46,s/l,487,0.10,1.18283,1.18283,1.17283,-25.00,1001094.78
1463,2020.08.28 06:52,s/l,488,0.10,1.18538,1.18538,1.17538,-24.97,1001069.81
1466,2020.08.31 14:25,t/p,489,0.10,1.19346,1.18346,1.19346,74.36,1001144.17
1469,2020.09.01 20:10,s/l,490,0.10,1.19153,1.19153,1.20153,-25.64,1001118.53
1472,2020.09.02 16:31,t/p,491,0.10,1.18304,1.19304,1.18304,75.03,1001193.56
1475,2020.09.02 23:22,s/l,492,0.10,1.18530,1.18530,1.17530,-25.00,1001168.56
1478,2020.09.03 16:25,s/l,493,0.10,1.18470,1.18470,1.17470,-25.00,1001143.56
1481,2020.09.03 18:22,s/l,494,0.10,1.18221,1.18221,1.19221,-25.00,1001118.56
1484,2020.09.04 16:55,s/l,495,0.10,1.17941,1.17941,1.18941,-25.64,1001092.93
1487,2020.09.04 19:01,s/l,496,0.10,1.18229,1.18229,1.17229,-25.00,1001067.93
1490,2020.09.04 21:25,s/l,497,0.10,1.18484,1.18484,1.17484,-25.00,1001042.93
1493,2020.09.07 13:25,s/l,498,0.10,1.18184,1.18184,1.19184,-25.64,1001017.29
1496,2020.09.10 13:01,s/l,499,0.10,1.18442,1.18442,1.17442,-24.86,1000992.43
1499,2020.09.10 21:25,s/l,500,0.10,1.18222,1.18222,1.19222,-25.00,1000967.43
1502,2020.09.15 07:25,t/p,501,0.10,1.18935,1.17935,1.18935,73.09,1001040.52
1505,2020.09.15 15:55,s/l,502,0.10,1.18698,1.18698,1.19698,-25.00,1001015.52
1508,2020.09.16 21:52,t/p,503,0.10,1.17997,1.18997,1.17997,75.03,1001090.55
1511,2020.09.17 18:22,s/l,504,0.10,1.18220,1.18220,1.17220,-24.91,1001065.64
1514,2020.09.22 00:45,s/l,505,0.10,1.17980,1.17980,1.18980,-26.91,1001038.73
1517,2020.09.23 03:52,t/p,506,0.10,1.16909,1.17909,1.16909,75.03,1001113.76
1520,2020.09.23 12:10,s/l,507,0.10,1.17125,1.17125,1.16125,-25.00,1001088.76
1523,2020.09.23 14:55,s/l,508,0.10,1.16899,1.16899,1.17899,-25.00,1001063.76
1526,2020.09.23 17:25,s/l,509,0.10,1.16648,1.16648,1.17648,-25.00,1001038.76
1529,2020.09.23 23:59,close at stop,510,0.10,1.16605,1.17011,1.16011,15.60,1001054.36
